000100010001000100010
000101111101111111110
000101010101010101010
111171111116111111111
011101010101000100010
010101011111000100010
011111110001111111110
010101010001010100010
111111111111111111111
000101010101010101010
011101110101010101010
010111011101111111110
010100010101010101010
111111111111111111111
010101010101010101010
011101010101010101010
010111111111011111110
010100010101010101010
111111111111111111111
000100010001000100010
000100010001000100010